TMGreen IT OR Green information technology392	Hewlett Packard
TMVideoconferencing OR videoconference OR video conference OR video conferencing1098	Nokia
TMGreen IT OR Green information technology1041	National Football League
TMVoice over Internet Protocol OR Voice over IP OR VoIP OR IP telephony OR Internet telephony153	Microsoft
TMVideoconferencing OR videoconference OR video conference OR video conferencing608	Microsoft
TMGreen IT OR Green information technology538	Harvard
TMGreen IT OR Green information technology372	Microsoft
TMVoice over Internet Protocol OR Voice over IP OR VoIP OR IP telephony OR Internet telephony1174	Vonage
TMVoice over Internet Protocol OR Voice over IP OR VoIP OR IP telephony OR Internet telephony153	Hewlett Packard
TMGreen IT OR Green information technology945	eBay
TMGreen IT OR Green information technology551	Microsoft
TMVideoconferencing OR videoconference OR video conference OR video conferencing572	Intel
TMGreen IT OR Green information technology1017	Reuters
TMVoice over Internet Protocol OR Voice over IP OR VoIP OR IP telephony OR Internet telephony239	Google
TMGreen IT OR Green information technology1080	Dell
TMVoice over Internet Protocol OR Voice over IP OR VoIP OR IP telephony OR Internet telephony1259	Microsoft
TMGreen IT OR Green information technology1022	Microsoft
TMGreen IT OR Green information technology987	Intel
TMGreen IT OR Green information technology510	Google
TMGreen IT OR Green information technology993	New York Times
TMGreen IT OR Green information technology768	Intel
TMVideoconferencing OR videoconference OR video conference OR video conferencing1097	Cisco
TMGreen IT OR Green information technology629	Navy
TMVoice over Internet Protocol OR Voice over IP OR VoIP OR IP telephony OR Internet telephony170	Vonage
TMVoice over Internet Protocol OR Voice over IP OR VoIP OR IP telephony OR Internet telephony1190	Nokia
TMVoice over Internet Protocol OR Voice over IP OR VoIP OR IP telephony OR Internet telephony113	Nokia
TMGreen IT OR Green information technology1063	New York Times
TMTeleconferencing OR Teleconference OR teleseminar OR teleseminars359	eBay
TMGreen IT OR Green information technology987	Environmental Protection Agency
TMGreen IT OR Green information technology344	Microsoft
TMenvironmentally sustainable IT OR environmentally sustainable information technology OR environmentally friendly IT OR environmentally friendly information technology1142	Environmental Protection Agency
TMVoice over Internet Protocol OR Voice over IP OR VoIP OR IP telephony OR Internet telephony186	Microsoft
TMGreen IT OR Green information technology904	Microsoft
TMVoice over Internet Protocol OR Voice over IP OR VoIP OR IP telephony OR Internet telephony3	Dell
TMVoice over Internet Protocol OR Voice over IP OR VoIP OR IP telephony OR Internet telephony164	Vonage
TMVoice over Internet Protocol OR Voice over IP OR VoIP OR IP telephony OR Internet telephony1161	Microsoft
TMVoice over Internet Protocol OR Voice over IP OR VoIP OR IP telephony OR Internet telephony830	Google
TMVoice over Internet Protocol OR Voice over IP OR VoIP OR IP telephony OR Internet telephony801	Comcast
TMVideoconferencing OR videoconference OR video conference OR video conferencing42	Cisco
TMGreen IT OR Green information technology718	Hewlett Packard
TMGreen IT OR Green information technology700	Reuters
TMVoice over Internet Protocol OR Voice over IP OR VoIP OR IP telephony OR Internet telephony245	Comcast
TMVoice over Internet Protocol OR Voice over IP OR VoIP OR IP telephony OR Internet telephony283	Cisco
TMGreen IT OR Green information technology939	Nokia
TMGreen IT OR Green information technology506	Army
TMVideoconferencing OR videoconference OR video conference OR video conferencing35	Hewlett Packard
TMVideoconferencing OR videoconference OR video conference OR video conferencing71	Intel
TMVideoconferencing OR videoconference OR video conference OR video conferencing1101	New York Times
TMVideoconferencing OR videoconference OR video conference OR video conferencing45	Intel
TMVideoconferencing OR videoconference OR video conference OR video conferencing52	Hewlett Packard
TMGreen IT OR Green information technology433	eBay
TMVoice over Internet Protocol OR Voice over IP OR VoIP OR IP telephony OR Internet telephony310	Google
TMVoice over Internet Protocol OR Voice over IP OR VoIP OR IP telephony OR Internet telephony289	Google
TMGreen IT OR Green information technology1084	CNN
TMVideoconferencing OR videoconference OR video conference OR video conferencing1104	Nokia
TMVideoconferencing OR videoconference OR video conference OR video conferencing52	Dell
TMVoice over Internet Protocol OR Voice over IP OR VoIP OR IP telephony OR Internet telephony1265	Senate
TMVoice over Internet Protocol OR Voice over IP OR VoIP OR IP telephony OR Internet telephony1261	Securities and Exchange Commission
TMGreen IT OR Green information technology937	Google
TMVoice over Internet Protocol OR Voice over IP OR VoIP OR IP telephony OR Internet telephony829	Wall Street Journal
TMGreen IT OR Green information technology449	Google
TMVoice over Internet Protocol OR Voice over IP OR VoIP OR IP telephony OR Internet telephony1273	Nokia
TMGreen IT OR Green information technology410	Nokia
TMVoice over Internet Protocol OR Voice over IP OR VoIP OR IP telephony OR Internet telephony270	Comcast
TMGreen IT OR Green information technology365	Environmental Protection Agency
TMenvironmentally sustainable IT OR environmentally sustainable information technology OR environmentally friendly IT OR environmentally friendly information technology1145	eBay
TMVoice over Internet Protocol OR Voice over IP OR VoIP OR IP telephony OR Internet telephony1314	CNN
TMVoice over Internet Protocol OR Voice over IP OR VoIP OR IP telephony OR Internet telephony188	Verizon
TMVoice over Internet Protocol OR Voice over IP OR VoIP OR IP telephony OR Internet telephony266	Cisco
TMVoice over Internet Protocol OR Voice over IP OR VoIP OR IP telephony OR Internet telephony289	Microsoft
TMVideoconferencing OR videoconference OR video conference OR video conferencing40	Microsoft
TMgreen grid1155	Dell
TMVoice over Internet Protocol OR Voice over IP OR VoIP OR IP telephony OR Internet telephony12	Microsoft
TMVoice over Internet Protocol OR Voice over IP OR VoIP OR IP telephony OR Internet telephony238	National Football League
TMGreen IT OR Green information technology504	Intel
TMVoice over Internet Protocol OR Voice over IP OR VoIP OR IP telephony OR Internet telephony211	Cisco
TMGreen IT OR Green information technology501	Reuters
TMGreen IT OR Green information technology941	Microsoft
TMVoice over Internet Protocol OR Voice over IP OR VoIP OR IP telephony OR Internet telephony1184	Google
TMGreen IT OR Green information technology543	Microsoft
TMVoice over Internet Protocol OR Voice over IP OR VoIP OR IP telephony OR Internet telephony29	Vonage
TMGreen IT OR Green information technology915	Microsoft
TMVoice over Internet Protocol OR Voice over IP OR VoIP OR IP telephony OR Internet telephony165	Vonage
TMTeleconferencing OR Teleconference OR teleseminar OR teleseminars1115	Google
TMVideoconferencing OR videoconference OR video conference OR video conferencing585	Cisco
TMVideoconferencing OR videoconference OR video conference OR video conferencing601	Google
TMGreen IT OR Green information technology460	Cisco
TMVoice over Internet Protocol OR Voice over IP OR VoIP OR IP telephony OR Internet telephony141	Nokia
TMVoice over Internet Protocol OR Voice over IP OR VoIP OR IP telephony OR Internet telephony276	Microsoft
TMGreen IT OR Green information technology684	Microsoft
TMVoice over Internet Protocol OR Voice over IP OR VoIP OR IP telephony OR Internet telephony1171	Nokia
TMVoice over Internet Protocol OR Voice over IP OR VoIP OR IP telephony OR Internet telephony1169	Nokia
TMGreen IT OR Green information technology665	Justice Department
TMVoice over Internet Protocol OR Voice over IP OR VoIP OR IP telephony OR Internet telephony266	Google
TMVoice over Internet Protocol OR Voice over IP OR VoIP OR IP telephony OR Internet telephony1162	Google
TMVoice over Internet Protocol OR Voice over IP OR VoIP OR IP telephony OR Internet telephony266	Microsoft
TMVideoconferencing OR videoconference OR video conference OR video conferencing587	Cisco
TMGreen IT OR Green information technology988	Microsoft
TMGreen IT OR Green information technology520	Intel
TMVoice over Internet Protocol OR Voice over IP OR VoIP OR IP telephony OR Internet telephony818	Nokia
TMGreen IT OR Green information technology925	eBay
TMGreen IT OR Green information technology506	Justice Department
TMVoice over Internet Protocol OR Voice over IP OR VoIP OR IP telephony OR Internet telephony274	Hewlett Packard
TMGreen IT OR Green information technology474	Dell
TMVoice over Internet Protocol OR Voice over IP OR VoIP OR IP telephony OR Internet telephony173	eBay
TMGreen IT OR Green information technology705	New York Times
TMGreen IT OR Green information technology707	Microsoft
TMGreen IT OR Green information technology985	Federal Reserve
TMGreen IT OR Green information technology449	Nokia
TMVideoconferencing OR videoconference OR video conference OR video conferencing1099	Congress
TMVideoconferencing OR videoconference OR video conference OR video conferencing560	Verizon
TMGreen IT OR Green information technology643	Comcast
TMVoice over Internet Protocol OR Voice over IP OR VoIP OR IP telephony OR Internet telephony1307	Google
TMVoice over Internet Protocol OR Voice over IP OR VoIP OR IP telephony OR Internet telephony1248	Vonage
TMGreen IT OR Green information technology970	Google
TMVideoconferencing OR videoconference OR video conference OR video conferencing570	eBay
TMGreen IT OR Green information technology1047	Dell
TMenvironmentally sustainable IT OR environmentally sustainable information technology OR environmentally friendly IT OR environmentally friendly information technology353	Harvard
TMVoice over Internet Protocol OR Voice over IP OR VoIP OR IP telephony OR Internet telephony813	eBay
TMVoice over Internet Protocol OR Voice over IP OR VoIP OR IP telephony OR Internet telephony1273	Wall Street Journal
TMVoice over Internet Protocol OR Voice over IP OR VoIP OR IP telephony OR Internet telephony1271	Hewlett Packard
TMGreen IT OR Green information technology405	Google
TMVoice over Internet Protocol OR Voice over IP OR VoIP OR IP telephony OR Internet telephony155	Google
TMVoice over Internet Protocol OR Voice over IP OR VoIP OR IP telephony OR Internet telephony175	Verizon
TMVoice over Internet Protocol OR Voice over IP OR VoIP OR IP telephony OR Internet telephony168	Congress
TMGreen IT OR Green information technology942	Navy
TMVoice over Internet Protocol OR Voice over IP OR VoIP OR IP telephony OR Internet telephony290	eBay
TMVoice over Internet Protocol OR Voice over IP OR VoIP OR IP telephony OR Internet telephony1265	Congress
TMVoice over Internet Protocol OR Voice over IP OR VoIP OR IP telephony OR Internet telephony1270	eBay
TMVoice over Internet Protocol OR Voice over IP OR VoIP OR IP telephony OR Internet telephony178	Vonage
TMGreen IT OR Green information technology515	Dell
TMGreen IT OR Green information technology935	Microsoft
TMVoice over Internet Protocol OR Voice over IP OR VoIP OR IP telephony OR Internet telephony1276	Microsoft
TMVoice over Internet Protocol OR Voice over IP OR VoIP OR IP telephony OR Internet telephony147	Microsoft
TMVoice over Internet Protocol OR Voice over IP OR VoIP OR IP telephony OR Internet telephony174	Cisco
TMVoice over Internet Protocol OR Voice over IP OR VoIP OR IP telephony OR Internet telephony304	Comcast
TMVoice over Internet Protocol OR Voice over IP OR VoIP OR IP telephony OR Internet telephony1271	Dell
TMVoice over Internet Protocol OR Voice over IP OR VoIP OR IP telephony OR Internet telephony125	Google
TMGreen IT OR Green information technology990	Justice Department
TMGreen IT OR Green information technology1058	Google
TMVoice over Internet Protocol OR Voice over IP OR VoIP OR IP telephony OR Internet telephony317	Nokia
TMVoice over Internet Protocol OR Voice over IP OR VoIP OR IP telephony OR Internet telephony1307	Intel
TMTeleconferencing OR Teleconference OR teleseminar OR teleseminars360	Intel
TMVoice over Internet Protocol OR Voice over IP OR VoIP OR IP telephony OR Internet telephony1276	Army
TMGreen IT OR Green information technology684	Cisco
TMVoice over Internet Protocol OR Voice over IP OR VoIP OR IP telephony OR Internet telephony854	New York Times
TMVoice over Internet Protocol OR Voice over IP OR VoIP OR IP telephony OR Internet telephony307	Nokia
TMVoice over Internet Protocol OR Voice over IP OR VoIP OR IP telephony OR Internet telephony171	Vonage
TMVoice over Internet Protocol OR Voice over IP OR VoIP OR IP telephony OR Internet telephony825	Google
TMVoice over Internet Protocol OR Voice over IP OR VoIP OR IP telephony OR Internet telephony30	eBay
TMGreen IT OR Green information technology506	New York Times
TMVoice over Internet Protocol OR Voice over IP OR VoIP OR IP telephony OR Internet telephony1243	Vonage
TMGreen IT OR Green information technology528	Hewlett Packard
TMGreen IT OR Green information technology449	eBay
TMoptimal use of information technology OR optimal use of IT1128	New York Times
TMenvironmentally sustainable IT OR environmentally sustainable information technology OR environmentally friendly IT OR environmentally friendly information technology354	eBay
TMVoice over Internet Protocol OR Voice over IP OR VoIP OR IP telephony OR Internet telephony166	Vonage
TMGreen IT OR Green information technology378	Microsoft
TMenvironmentally sustainable IT OR environmentally sustainable information technology OR environmentally friendly IT OR environmentally friendly information technology552	Intel
TMGreen IT OR Green information technology532	Microsoft
TMGreen IT OR Green information technology367	Wall Street Journal
TMGreen IT OR Green information technology528	Dell
TMVideoconferencing OR videoconference OR video conference OR video conferencing601	Microsoft
TMVoice over Internet Protocol OR Voice over IP OR VoIP OR IP telephony OR Internet telephony136	Verizon
TMGreen IT OR Green information technology1064	New York Times
TMGreen IT OR Green information technology628	Microsoft
TMGreen IT OR Green information technology1080	Microsoft
TMVoice over Internet Protocol OR Voice over IP OR VoIP OR IP telephony OR Internet telephony326	Nokia
TMGreen IT OR Green information technology940	Dell
TMGreen IT OR Green information technology953	Microsoft
TMVoice over Internet Protocol OR Voice over IP OR VoIP OR IP telephony OR Internet telephony161	Microsoft
TMVideoconferencing OR videoconference OR video conference OR video conferencing56	Comcast
TMGreen IT OR Green information technology461	Google
TMGreen IT OR Green information technology952	Google
TMenergy star OR energy stars583	Intel
TMGreen IT OR Green information technology954	eBay
TMTeleconferencing OR Teleconference OR teleseminar OR teleseminars358	Cisco
TMTeleconferencing OR Teleconference OR teleseminar OR teleseminars584	Microsoft
TMVoice over Internet Protocol OR Voice over IP OR VoIP OR IP telephony OR Internet telephony113	Reuters
TMGreen IT OR Green information technology762	Google
TMVideoconferencing OR videoconference OR video conference OR video conferencing576	Taliban
TMVoice over Internet Protocol OR Voice over IP OR VoIP OR IP telephony OR Internet telephony295	Microsoft
TMGreen IT OR Green information technology696	Microsoft
TMVideoconferencing OR videoconference OR video conference OR video conferencing597	Comcast
TMVideoconferencing OR videoconference OR video conference OR video conferencing605	Hewlett Packard
TMVoice over Internet Protocol OR Voice over IP OR VoIP OR IP telephony OR Internet telephony125	Treasury
TMVoice over Internet Protocol OR Voice over IP OR VoIP OR IP telephony OR Internet telephony147	Cisco
TMVoice over Internet Protocol OR Voice over IP OR VoIP OR IP telephony OR Internet telephony142	Google
TMGreen IT OR Green information technology1021	Microsoft
TMTeleconferencing OR Teleconference OR teleseminar OR teleseminars336	Google
TMVoice over Internet Protocol OR Voice over IP OR VoIP OR IP telephony OR Internet telephony276	New York Times
TMVoice over Internet Protocol OR Voice over IP OR VoIP OR IP telephony OR Internet telephony153	Intel
TMVoice over Internet Protocol OR Voice over IP OR VoIP OR IP telephony OR Internet telephony1244	Verizon
TMVideoconferencing OR videoconference OR video conference OR video conferencing605	Cisco
TMVoice over Internet Protocol OR Voice over IP OR VoIP OR IP telephony OR Internet telephony801	Google
TMVoice over Internet Protocol OR Voice over IP OR VoIP OR IP telephony OR Internet telephony83	Vonage
TMenergy star OR energy stars580	Dell
TMVoice over Internet Protocol OR Voice over IP OR VoIP OR IP telephony OR Internet telephony2	Cisco
TMGreen IT OR Green information technology662	Congress
TMVideoconferencing OR videoconference OR video conference OR video conferencing569	Microsoft
TMGreen IT OR Green information technology947	Treasury
TMVoice over Internet Protocol OR Voice over IP OR VoIP OR IP telephony OR Internet telephony1227	Google
TMVoice over Internet Protocol OR Voice over IP OR VoIP OR IP telephony OR Internet telephony288	eBay
TMVoice over Internet Protocol OR Voice over IP OR VoIP OR IP telephony OR Internet telephony1293	Intel
TMVoice over Internet Protocol OR Voice over IP OR VoIP OR IP telephony OR Internet telephony198	Comcast
TMVoice over Internet Protocol OR Voice over IP OR VoIP OR IP telephony OR Internet telephony5	Vonage
TMVideoconferencing OR videoconference OR video conference OR video conferencing38	Cisco
TMVoice over Internet Protocol OR Voice over IP OR VoIP OR IP telephony OR Internet telephony286	Reuters
TMGreen IT OR Green information technology947	Reuters
TMGreen IT OR Green information technology522	Dell
TMVoice over Internet Protocol OR Voice over IP OR VoIP OR IP telephony OR Internet telephony1262	eBay
TMGreen IT OR Green information technology970	eBay
TMGreen IT OR Green information technology661	Nokia
TMVoice over Internet Protocol OR Voice over IP OR VoIP OR IP telephony OR Internet telephony1178	Nokia
TMVoice over Internet Protocol OR Voice over IP OR VoIP OR IP telephony OR Internet telephony1299	National Football League
TMGreen IT OR Green information technology704	Google
TMVoice over Internet Protocol OR Voice over IP OR VoIP OR IP telephony OR Internet telephony829	Comcast
TMVoice over Internet Protocol OR Voice over IP OR VoIP OR IP telephony OR Internet telephony1277	eBay
TMVoice over Internet Protocol OR Voice over IP OR VoIP OR IP telephony OR Internet telephony831	eBay
TMVoice over Internet Protocol OR Voice over IP OR VoIP OR IP telephony OR Internet telephony247	Microsoft
TMVoice over Internet Protocol OR Voice over IP OR VoIP OR IP telephony OR Internet telephony328	Intel
TMGreen IT OR Green information technology989	Microsoft
TMGreen IT OR Green information technology658	Google
TMVoice over Internet Protocol OR Voice over IP OR VoIP OR IP telephony OR Internet telephony185	Microsoft
TMVoice over Internet Protocol OR Voice over IP OR VoIP OR IP telephony OR Internet telephony318	Cisco
TMoptimal use of information technology OR optimal use of IT1128	Nokia
TMenergy star OR energy stars580	Intel
TMGreen IT OR Green information technology1047	Intel
TMVideoconferencing OR videoconference OR video conference OR video conferencing589	Cisco
TMGreen IT OR Green information technology942	National Aeronautics and Space Administration
TMGreen IT OR Green information technology1084	Justice Department
TMVoice over Internet Protocol OR Voice over IP OR VoIP OR IP telephony OR Internet telephony1268	Wall Street Journal
TMenvironmentally sustainable IT OR environmentally sustainable information technology OR environmentally friendly IT OR environmentally friendly information technology354	Microsoft
TMVoice over Internet Protocol OR Voice over IP OR VoIP OR IP telephony OR Internet telephony863	Wall Street Journal
TMVideoconferencing OR videoconference OR video conference OR video conferencing66	Cisco
TMcomputer recycling OR electronic recycling OR computer recyc OR electronic recyc OR e recycling OR e recyc1159	Microsoft
TMVideoconferencing OR videoconference OR video conference OR video conferencing81	Microsoft
TMenvironmentally sustainable IT OR environmentally sustainable information technology OR environmentally friendly IT OR environmentally friendly information technology1321	eBay
TMVideoconferencing OR videoconference OR video conference OR video conferencing69	eBay
TMVoice over Internet Protocol OR Voice over IP OR VoIP OR IP telephony OR Internet telephony179	Nokia
TMVoice over Internet Protocol OR Voice over IP OR VoIP OR IP telephony OR Internet telephony304	Intel
TMenergy star OR energy stars583	Environmental Protection Agency
TMGreen IT OR Green information technology543	Nokia
TMVoice over Internet Protocol OR Voice over IP OR VoIP OR IP telephony OR Internet telephony212	New York Times
TMVoice over Internet Protocol OR Voice over IP OR VoIP OR IP telephony OR Internet telephony229	Nokia
TMVideoconferencing OR videoconference OR video conference OR video conferencing570	Intel
TMGreen IT OR Green information technology942	Google
TMVideoconferencing OR videoconference OR video conference OR video conferencing1114	Microsoft
TMVideoconferencing OR videoconference OR video conference OR video conferencing569	Cisco
TMGreen IT OR Green information technology490	New York Times
TMVoice over Internet Protocol OR Voice over IP OR VoIP OR IP telephony OR Internet telephony181	Nokia
TMVoice over Internet Protocol OR Voice over IP OR VoIP OR IP telephony OR Internet telephony100	eBay
TMVoice over Internet Protocol OR Voice over IP OR VoIP OR IP telephony OR Internet telephony83	Microsoft
TMVoice over Internet Protocol OR Voice over IP OR VoIP OR IP telephony OR Internet telephony1184	eBay
TMGreen IT OR Green information technology341	New York Times
TMVoice over Internet Protocol OR Voice over IP OR VoIP OR IP telephony OR Internet telephony1268	Vonage
TMgreen grid794	Microsoft
TMGreen IT OR Green information technology987	Department of Energy
TMVideoconferencing OR videoconference OR video conference OR video conferencing570	Microsoft
TMVoice over Internet Protocol OR Voice over IP OR VoIP OR IP telephony OR Internet telephony176	eBay
TMVideoconferencing OR videoconference OR video conference OR video conferencing62	Microsoft
TMVideoconferencing OR videoconference OR video conference OR video conferencing614	Hewlett Packard
TMVoice over Internet Protocol OR Voice over IP OR VoIP OR IP telephony OR Internet telephony161	Verizon
TMVoice over Internet Protocol OR Voice over IP OR VoIP OR IP telephony OR Internet telephony1267	Vonage
TMVoice over Internet Protocol OR Voice over IP OR VoIP OR IP telephony OR Internet telephony191	Cisco
TMTeleconferencing OR Teleconference OR teleseminar OR teleseminars1120	Verizon
TMVoice over Internet Protocol OR Voice over IP OR VoIP OR IP telephony OR Internet telephony1310	Microsoft
TMGreen IT OR Green information technology987	Dell
TMGreen IT OR Green information technology444	Google
TMGreen IT OR Green information technology940	Hewlett Packard
TMVoice over Internet Protocol OR Voice over IP OR VoIP OR IP telephony OR Internet telephony86	Google
TMVoice over Internet Protocol OR Voice over IP OR VoIP OR IP telephony OR Internet telephony296	Vonage
TMVideoconferencing OR videoconference OR video conference OR video conferencing40	Cisco
TMGreen IT OR Green information technology937	eBay
TMVoice over Internet Protocol OR Voice over IP OR VoIP OR IP telephony OR Internet telephony276	National Collegiate Athletic Association
TMGreen IT OR Green information technology344	Comcast
TMVoice over Internet Protocol OR Voice over IP OR VoIP OR IP telephony OR Internet telephony136	Vonage
TMVoice over Internet Protocol OR Voice over IP OR VoIP OR IP telephony OR Internet telephony1227	Microsoft
TMVoice over Internet Protocol OR Voice over IP OR VoIP OR IP telephony OR Internet telephony1169	Microsoft
TMGreen IT OR Green information technology937	CNN
TMGreen IT OR Green information technology474	Intel
TMelectronic waste OR e waste OR e scrap OR electronic scrap1160	Environmental Protection Agency
TMgreen grid1155	Environmental Protection Agency
TMGreen IT OR Green information technology551	Dell
TMVoice over Internet Protocol OR Voice over IP OR VoIP OR IP telephony OR Internet telephony133	Vonage
TMVoice over Internet Protocol OR Voice over IP OR VoIP OR IP telephony OR Internet telephony168	Verizon
TMVoice over Internet Protocol OR Voice over IP OR VoIP OR IP telephony OR Internet telephony851	Cisco
TMGreen IT OR Green information technology1024	Microsoft
TMVoice over Internet Protocol OR Voice over IP OR VoIP OR IP telephony OR Internet telephony849	Wall Street Journal
TMVoice over Internet Protocol OR Voice over IP OR VoIP OR IP telephony OR Internet telephony1318	Microsoft
TMVoice over Internet Protocol OR Voice over IP OR VoIP OR IP telephony OR Internet telephony1171	Intel
TMVideoconferencing OR videoconference OR video conference OR video conferencing892	Microsoft
TMVideoconferencing OR videoconference OR video conference OR video conferencing587	Dell
TMVideoconferencing OR videoconference OR video conference OR video conferencing1113	Intel
TMVideoconferencing OR videoconference OR video conference OR video conferencing614	Microsoft
TMVideoconferencing OR videoconference OR video conference OR video conferencing562	Microsoft
TMVoice over Internet Protocol OR Voice over IP OR VoIP OR IP telephony OR Internet telephony297	Microsoft
TMVoice over Internet Protocol OR Voice over IP OR VoIP OR IP telephony OR Internet telephony1307	Microsoft
TMVoice over Internet Protocol OR Voice over IP OR VoIP OR IP telephony OR Internet telephony22	Nokia
TMGreen IT OR Green information technology367	Dell
TMGreen IT OR Green information technology700	Dell
TMVoice over Internet Protocol OR Voice over IP OR VoIP OR IP telephony OR Internet telephony1266	Microsoft
TMVoice over Internet Protocol OR Voice over IP OR VoIP OR IP telephony OR Internet telephony30	Reuters
TMVideoconferencing OR videoconference OR video conference OR video conferencing53	eBay
TMVoice over Internet Protocol OR Voice over IP OR VoIP OR IP telephony OR Internet telephony870	eBay
TMGreen IT OR Green information technology1018	Intel
TMGreen IT OR Green information technology551	Intel
TMVoice over Internet Protocol OR Voice over IP OR VoIP OR IP telephony OR Internet telephony265	Google
TMVoice over Internet Protocol OR Voice over IP OR VoIP OR IP telephony OR Internet telephony1243	Comcast
TMenvironmentally sustainable IT OR environmentally sustainable information technology OR environmentally friendly IT OR environmentally friendly information technology552	Dell
TMGreen IT OR Green information technology916	Hewlett Packard
TMGreen IT OR Green information technology777	Microsoft
TMVoice over Internet Protocol OR Voice over IP OR VoIP OR IP telephony OR Internet telephony1162	Microsoft
TMGreen IT OR Green information technology365	Hewlett Packard
TMVoice over Internet Protocol OR Voice over IP OR VoIP OR IP telephony OR Internet telephony253	eBay
TMGreen IT OR Green information technology444	Cisco
TMGreen IT OR Green information technology983	Associated Press
TMGreen IT OR Green information technology952	CIA
TMVoice over Internet Protocol OR Voice over IP OR VoIP OR IP telephony OR Internet telephony1307	Cisco
TMVideoconferencing OR videoconference OR video conference OR video conferencing50	Microsoft
TMVoice over Internet Protocol OR Voice over IP OR VoIP OR IP telephony OR Internet telephony11	Microsoft
TMVoice over Internet Protocol OR Voice over IP OR VoIP OR IP telephony OR Internet telephony1187	Intel
TMVoice over Internet Protocol OR Voice over IP OR VoIP OR IP telephony OR Internet telephony259	Nokia
TMVoice over Internet Protocol OR Voice over IP OR VoIP OR IP telephony OR Internet telephony1316	Intel
TMVoice over Internet Protocol OR Voice over IP OR VoIP OR IP telephony OR Internet telephony273	Cisco
TMGreen IT OR Green information technology1004	Intel
TMVoice over Internet Protocol OR Voice over IP OR VoIP OR IP telephony OR Internet telephony830	eBay
TMVoice over Internet Protocol OR Voice over IP OR VoIP OR IP telephony OR Internet telephony1318	Intel
TMVoice over Internet Protocol OR Voice over IP OR VoIP OR IP telephony OR Internet telephony118	Comcast
TMGreen IT OR Green information technology443	Microsoft
TMVoice over Internet Protocol OR Voice over IP OR VoIP OR IP telephony OR Internet telephony169	Nokia
TMGreen IT OR Green information technology1072	Microsoft
TMGreen IT OR Green information technology913	Dell
TMVideoconferencing OR videoconference OR video conference OR video conferencing56	Congress
TMGreen IT OR Green information technology483	Google
TMVoice over Internet Protocol OR Voice over IP OR VoIP OR IP telephony OR Internet telephony16	Microsoft
TMGreen IT OR Green information technology779	Intel
TMVoice over Internet Protocol OR Voice over IP OR VoIP OR IP telephony OR Internet telephony1253	eBay
TMGreen IT OR Green information technology1019	Treasury
TMgreen grid1155	Treasury
TMVoice over Internet Protocol OR Voice over IP OR VoIP OR IP telephony OR Internet telephony812	Google
TMVoice over Internet Protocol OR Voice over IP OR VoIP OR IP telephony OR Internet telephony1242	Microsoft
TMVoice over Internet Protocol OR Voice over IP OR VoIP OR IP telephony OR Internet telephony1277	CNN
TMVoice over Internet Protocol OR Voice over IP OR VoIP OR IP telephony OR Internet telephony139	Nokia
TMVideoconferencing OR videoconference OR video conference OR video conferencing574	Microsoft
TMGreen IT OR Green information technology629	Harvard
TMVideoconferencing OR videoconference OR video conference OR video conferencing1104	eBay
TMGreen IT OR Green information technology704	Nokia
TMcomputer recycling OR electronic recycling OR computer recyc OR electronic recyc OR e recycling OR e recyc357	Environmental Protection Agency
TMserver consolidation OR server consolidat340	Microsoft
TMVoice over Internet Protocol OR Voice over IP OR VoIP OR IP telephony OR Internet telephony83	Cisco
TMGreen IT OR Green information technology466	Microsoft
TMVideoconferencing OR videoconference OR video conference OR video conferencing33	Cisco
TMVideoconferencing OR videoconference OR video conference OR video conferencing587	Hewlett Packard
TMVideoconferencing OR videoconference OR video conference OR video conferencing71	Microsoft
TMVoice over Internet Protocol OR Voice over IP OR VoIP OR IP telephony OR Internet telephony18	Verizon
TMVideoconferencing OR videoconference OR video conference OR video conferencing568	Intel
TMGreen IT OR Green information technology677	Treasury
TMenvironmentally sustainable IT OR environmentally sustainable information technology OR environmentally friendly IT OR environmentally friendly information technology1139	Harvard
TMGreen IT OR Green information technology658	Harvard
TMGreen IT OR Green information technology392	Intel
TMGreen IT OR Green information technology367	Google
TMGreen IT OR Green information technology531	Microsoft
TMVoice over Internet Protocol OR Voice over IP OR VoIP OR IP telephony OR Internet telephony142	Verizon
TMVoice over Internet Protocol OR Voice over IP OR VoIP OR IP telephony OR Internet telephony134	Treasury
TMVideoconferencing OR videoconference OR video conference OR video conferencing71	Nokia
TMVoice over Internet Protocol OR Voice over IP OR VoIP OR IP telephony OR Internet telephony265	Microsoft
TMGreen IT OR Green information technology467	Microsoft
TMVideoconferencing OR videoconference OR video conference OR video conferencing1114	Intel
TMVoice over Internet Protocol OR Voice over IP OR VoIP OR IP telephony OR Internet telephony197	New York Times
TMGreen IT OR Green information technology368	Microsoft
TMVoice over Internet Protocol OR Voice over IP OR VoIP OR IP telephony OR Internet telephony289	Cisco
TMGreen IT OR Green information technology461	eBay
TMVoice over Internet Protocol OR Voice over IP OR VoIP OR IP telephony OR Internet telephony217	Nokia
TMGreen IT OR Green information technology481	New York Times
TMGreen IT OR Green information technology1014	Microsoft
TMVoice over Internet Protocol OR Voice over IP OR VoIP OR IP telephony OR Internet telephony161	Vonage
TMGreen IT OR Green information technology952	Microsoft
TMGreen IT OR Green information technology384	Congress
TMGreen IT OR Green information technology461	National Collegiate Athletic Association
TMGreen IT OR Green information technology646	Columbia
TMVideoconferencing OR videoconference OR video conference OR video conferencing612	Google
TMVoice over Internet Protocol OR Voice over IP OR VoIP OR IP telephony OR Internet telephony186	Cisco
TMGreen IT OR Green information technology952	Treasury
TMVoice over Internet Protocol OR Voice over IP OR VoIP OR IP telephony OR Internet telephony176	Microsoft
TMVoice over Internet Protocol OR Voice over IP OR VoIP OR IP telephony OR Internet telephony1301	CNN
TMVoice over Internet Protocol OR Voice over IP OR VoIP OR IP telephony OR Internet telephony265	Cisco
TMVideoconferencing OR videoconference OR video conference OR video conferencing58	Microsoft
TMGreen IT OR Green information technology537	Environmental Protection Agency
TMVoice over Internet Protocol OR Voice over IP OR VoIP OR IP telephony OR Internet telephony177	Comcast
TMVoice over Internet Protocol OR Voice over IP OR VoIP OR IP telephony OR Internet telephony1307	Vonage
TMGreen IT OR Green information technology718	Dell
TMVoice over Internet Protocol OR Voice over IP OR VoIP OR IP telephony OR Internet telephony809	eBay
TMGreen IT OR Green information technology546	Microsoft
TMGreen IT OR Green information technology683	Pentagon
TMGreen IT OR Green information technology496	eBay
TMvoice over broadband OR VoBB OR broadband telephony OR broadband phone902	Comcast
TMVoice over Internet Protocol OR Voice over IP OR VoIP OR IP telephony OR Internet telephony328	Microsoft
TMVoice over Internet Protocol OR Voice over IP OR VoIP OR IP telephony OR Internet telephony238	Nokia
TMVoice over Internet Protocol OR Voice over IP OR VoIP OR IP telephony OR Internet telephony283	Comcast
TMVoice over Internet Protocol OR Voice over IP OR VoIP OR IP telephony OR Internet telephony1226	Nokia
TMVideoconferencing OR videoconference OR video conference OR video conferencing33	Harvard
TMVoice over Internet Protocol OR Voice over IP OR VoIP OR IP telephony OR Internet telephony872	Google
TMVoice over Internet Protocol OR Voice over IP OR VoIP OR IP telephony OR Internet telephony1236	New York Times
TMGreen IT OR Green information technology419	New York Times
TMGreen IT OR Green information technology1074	Dell
TMGreen IT OR Green information technology1008	eBay
TMVoice over Internet Protocol OR Voice over IP OR VoIP OR IP telephony OR Internet telephony247	Nokia
TMVideoconferencing OR videoconference OR video conference OR video conferencing72	eBay
TMVoice over Internet Protocol OR Voice over IP OR VoIP OR IP telephony OR Internet telephony1265	Comcast
TMGreen IT OR Green information technology1095	Microsoft
TMVideoconferencing OR videoconference OR video conference OR video conferencing39	Intel
TMGreen IT OR Green information technology365	Dell
TMVoice over Internet Protocol OR Voice over IP OR VoIP OR IP telephony OR Internet telephony8	Microsoft
TMVoice over Internet Protocol OR Voice over IP OR VoIP OR IP telephony OR Internet telephony328	Cisco
TMGreen IT OR Green information technology497	Comcast
TMVoice over Internet Protocol OR Voice over IP OR VoIP OR IP telephony OR Internet telephony327	Dell
TMVoice over Internet Protocol OR Voice over IP OR VoIP OR IP telephony OR Internet telephony212	Cisco
TMGreen IT OR Green information technology446	Comcast
TMVideoconferencing OR videoconference OR video conference OR video conferencing612	Microsoft
TMVideoconferencing OR videoconference OR video conference OR video conferencing1113	Microsoft
TMVideoconferencing OR videoconference OR video conference OR video conferencing62	Cisco
TMVoice over Internet Protocol OR Voice over IP OR VoIP OR IP telephony OR Internet telephony194	Cisco
TMVoice over Internet Protocol OR Voice over IP OR VoIP OR IP telephony OR Internet telephony815	Comcast
TMVoice over Internet Protocol OR Voice over IP OR VoIP OR IP telephony OR Internet telephony825	Microsoft
TMGreen IT OR Green information technology987	Treasury
TMGreen IT OR Green information technology652	Google
TMVoice over Internet Protocol OR Voice over IP OR VoIP OR IP telephony OR Internet telephony1256	Verizon
TMVoice over Internet Protocol OR Voice over IP OR VoIP OR IP telephony OR Internet telephony29	Microsoft
TMGreen IT OR Green information technology1032	Google
TMVoice over Internet Protocol OR Voice over IP OR VoIP OR IP telephony OR Internet telephony224	Taliban
TMVoice over Internet Protocol OR Voice over IP OR VoIP OR IP telephony OR Internet telephony327	Microsoft
TMGreen IT OR Green information technology1029	Vonage
TMVoice over Internet Protocol OR Voice over IP OR VoIP OR IP telephony OR Internet telephony262	Nokia
TMGreen IT OR Green information technology461	Microsoft
TMTeleconferencing OR Teleconference OR teleseminar OR teleseminars336	Microsoft
TMGreen IT OR Green information technology753	Google
TMVoice over Internet Protocol OR Voice over IP OR VoIP OR IP telephony OR Internet telephony1301	Senate
TMVoice over Internet Protocol OR Voice over IP OR VoIP OR IP telephony OR Internet telephony218	Nokia
TMVoice over Internet Protocol OR Voice over IP OR VoIP OR IP telephony OR Internet telephony1301	eBay
TMVoice over Internet Protocol OR Voice over IP OR VoIP OR IP telephony OR Internet telephony105	Google
TMenvironmentally sustainable IT OR environmentally sustainable information technology OR environmentally friendly IT OR environmentally friendly information technology353	Microsoft
TMGreen IT OR Green information technology534	Microsoft
TMGreen IT OR Green information technology776	New York Times
TMGreen IT OR Green information technology1008	Microsoft
TMGreen IT OR Green information technology1013	Microsoft
TMVoice over Internet Protocol OR Voice over IP OR VoIP OR IP telephony OR Internet telephony175	Vonage
TMVoice over Internet Protocol OR Voice over IP OR VoIP OR IP telephony OR Internet telephony296	Comcast
TMVoice over Internet Protocol OR Voice over IP OR VoIP OR IP telephony OR Internet telephony1235	Vonage
TMVoice over Internet Protocol OR Voice over IP OR VoIP OR IP telephony OR Internet telephony168	Microsoft
TMVoice over Internet Protocol OR Voice over IP OR VoIP OR IP telephony OR Internet telephony174	Microsoft
TMGreen IT OR Green information technology506	Pentagon
TMVoice over Internet Protocol OR Voice over IP OR VoIP OR IP telephony OR Internet telephony240	Google
TMGreen IT OR Green information technology482	Google
TMVoice over Internet Protocol OR Voice over IP OR VoIP OR IP telephony OR Internet telephony825	Cisco
TMGreen IT OR Green information technology665	Microsoft
TMVideoconferencing OR videoconference OR video conference OR video conferencing618	Microsoft
TMGreen IT OR Green information technology1004	Environmental Protection Agency
TMVideoconferencing OR videoconference OR video conference OR video conferencing585	New York Times
TMVoice over Internet Protocol OR Voice over IP OR VoIP OR IP telephony OR Internet telephony231	Cisco
TMVideoconferencing OR videoconference OR video conference OR video conferencing52	Microsoft
TMVoice over Internet Protocol OR Voice over IP OR VoIP OR IP telephony OR Internet telephony1299	Google
TMVoice over Internet Protocol OR Voice over IP OR VoIP OR IP telephony OR Internet telephony295	Google
TMGreen IT OR Green information technology785	CNN
TMGreen IT OR Green information technology1075	Microsoft
TMVideoconferencing OR videoconference OR video conference OR video conferencing1112	Intel
TMGreen IT OR Green information technology952	Securities and Exchange Commission
TMVideoconferencing OR videoconference OR video conference OR video conferencing52	Cisco
TMGreen IT OR Green information technology758	Nokia
TMGreen IT OR Green information technology461	Cisco
TMVideoconferencing OR videoconference OR video conference OR video conferencing72	Google
TMgreen grid1155	Intel
TMVoice over Internet Protocol OR Voice over IP OR VoIP OR IP telephony OR Internet telephony327	Cisco
TMGreen IT OR Green information technology709	Google
TMGreen IT OR Green information technology465	Microsoft
TMVoice over Internet Protocol OR Voice over IP OR VoIP OR IP telephony OR Internet telephony329	Vonage
TMVideoconferencing OR videoconference OR video conference OR video conferencing35	Cisco
TMVoice over Internet Protocol OR Voice over IP OR VoIP OR IP telephony OR Internet telephony1167	Microsoft
TMVoice over Internet Protocol OR Voice over IP OR VoIP OR IP telephony OR Internet telephony9	Microsoft
TMGreen IT OR Green information technology705	CNN
TMVoice over Internet Protocol OR Voice over IP OR VoIP OR IP telephony OR Internet telephony841	Google
TMVoice over Internet Protocol OR Voice over IP OR VoIP OR IP telephony OR Internet telephony1268	Reuters
TMGreen IT OR Green information technology1064	Microsoft
TMVoice over Internet Protocol OR Voice over IP OR VoIP OR IP telephony OR Internet telephony276	Cisco
TMGreen IT OR Green information technology629	Treasury
TMVoice over Internet Protocol OR Voice over IP OR VoIP OR IP telephony OR Internet telephony5	Wall Street Journal
TMGreen IT OR Green information technology782	Google
TMGreen IT OR Green information technology785	New York Times
TMGreen IT OR Green information technology460	Google
TMGreen IT OR Green information technology1059	Vonage
TMGreen IT OR Green information technology952	Reuters
TMGreen IT OR Green information technology493	Justice Department
TMVoice over Internet Protocol OR Voice over IP OR VoIP OR IP telephony OR Internet telephony99	Intel
TMGreen IT OR Green information technology534	CNN
TMGreen IT OR Green information technology443	Google
TMVoice over Internet Protocol OR Voice over IP OR VoIP OR IP telephony OR Internet telephony305	Cisco
TMVoice over Internet Protocol OR Voice over IP OR VoIP OR IP telephony OR Internet telephony30	Cisco
TMVoice over Internet Protocol OR Voice over IP OR VoIP OR IP telephony OR Internet telephony240	Microsoft
TMGreen IT OR Green information technology916	Google
TMVoice over Internet Protocol OR Voice over IP OR VoIP OR IP telephony OR Internet telephony209	Comcast
TMGreen IT OR Green information technology1092	Microsoft
TMGreen IT OR Green information technology628	New York Times
TMVoice over Internet Protocol OR Voice over IP OR VoIP OR IP telephony OR Internet telephony153	eBay
TMGreen IT OR Green information technology538	Microsoft
TMVideoconferencing OR videoconference OR video conference OR video conferencing68	Microsoft
TMGreen IT OR Green information technology497	Intel
TMGreen IT OR Green information technology752	Microsoft
TMVoice over Internet Protocol OR Voice over IP OR VoIP OR IP telephony OR Internet telephony83	Nokia
TMGreen IT OR Green information technology1092	Google
TMGreen IT OR Green information technology341	CNN
TMGreen IT OR Green information technology481	Cisco
TMVideoconferencing OR videoconference OR video conference OR video conferencing587	Intel
TMVideoconferencing OR videoconference OR video conference OR video conferencing607	Microsoft
TMVideoconferencing OR videoconference OR video conference OR video conferencing1109	Intel
TMGreen IT OR Green information technology392	Nokia
TMGreen IT OR Green information technology665	European Union
TMVideoconferencing OR videoconference OR video conference OR video conferencing1101	Cisco
TMVoice over Internet Protocol OR Voice over IP OR VoIP OR IP telephony OR Internet telephony273	Google
TMVideoconferencing OR videoconference OR video conference OR video conferencing47	Cisco
TMVideoconferencing OR videoconference OR video conference OR video conferencing592	Cisco
TMVoice over Internet Protocol OR Voice over IP OR VoIP OR IP telephony OR Internet telephony852	eBay
TMGreen IT OR Green information technology970	Intel
TMVoice over Internet Protocol OR Voice over IP OR VoIP OR IP telephony OR Internet telephony1316	Microsoft
TMVideoconferencing OR videoconference OR video conference OR video conferencing608	Wall Street Journal
TMVoice over Internet Protocol OR Voice over IP OR VoIP OR IP telephony OR Internet telephony202	eBay
TMVoice over Internet Protocol OR Voice over IP OR VoIP OR IP telephony OR Internet telephony1317	Microsoft
TMVideoconferencing OR videoconference OR video conference OR video conferencing596	Microsoft
TMVoice over Internet Protocol OR Voice over IP OR VoIP OR IP telephony OR Internet telephony1263	Vonage
TMGreen IT OR Green information technology534	Google
TMVoice over Internet Protocol OR Voice over IP OR VoIP OR IP telephony OR Internet telephony235	Nokia
TMGreen IT OR Green information technology528	Microsoft
TMVoice over Internet Protocol OR Voice over IP OR VoIP OR IP telephony OR Internet telephony276	Google
TMGreen IT OR Green information technology468	Microsoft
TMGreen IT OR Green information technology705	Nokia
TMGreen IT OR Green information technology952	Congress
TMVoice over Internet Protocol OR Voice over IP OR VoIP OR IP telephony OR Internet telephony274	Microsoft
TMVoice over Internet Protocol OR Voice over IP OR VoIP OR IP telephony OR Internet telephony176	Intel
TMVoice over Internet Protocol OR Voice over IP OR VoIP OR IP telephony OR Internet telephony216	Microsoft
TMVoice over Internet Protocol OR Voice over IP OR VoIP OR IP telephony OR Internet telephony207	Cisco
TMVoice over Internet Protocol OR Voice over IP OR VoIP OR IP telephony OR Internet telephony1265	Justice Department
TMcomputer recycling OR electronic recycling OR computer recyc OR electronic recyc OR e recycling OR e recyc1159	Dell
TMGreen IT OR Green information technology953	Google
TMGreen IT OR Green information technology1081	Microsoft
TMVideoconferencing OR videoconference OR video conference OR video conferencing618	Nokia
TMGreen IT OR Green information technology905	Microsoft
TMGreen IT OR Green information technology420	Federal Reserve
TMVideoconferencing OR videoconference OR video conference OR video conferencing605	Microsoft
TMoptimal use of information technology OR optimal use of IT1133	Google
TMGreen IT OR Green information technology665	Intel
TMVoice over Internet Protocol OR Voice over IP OR VoIP OR IP telephony OR Internet telephony21	Microsoft
TMVoice over Internet Protocol OR Voice over IP OR VoIP OR IP telephony OR Internet telephony274	Cisco
TMGreen IT OR Green information technology384	eBay
TMVoice over Internet Protocol OR Voice over IP OR VoIP OR IP telephony OR Internet telephony29	eBay
TMGreen IT OR Green information technology438	Nokia
TMGreen IT OR Green information technology443	Cisco
TMenvironmentally sustainable IT OR environmentally sustainable information technology OR environmentally friendly IT OR environmentally friendly information technology1150	Dell
TMGreen IT OR Green information technology392	Dell
TMVoice over Internet Protocol OR Voice over IP OR VoIP OR IP telephony OR Internet telephony1277	Microsoft
TMVoice over Internet Protocol OR Voice over IP OR VoIP OR IP telephony OR Internet telephony1226	Intel
TMVoice over Internet Protocol OR Voice over IP OR VoIP OR IP telephony OR Internet telephony276	eBay
TMGreen IT OR Green information technology427	Microsoft
TMGreen IT OR Green information technology718	Microsoft
TMGreen IT OR Green information technology452	Air Force
TMGreen IT OR Green information technology483	Microsoft
TMVoice over Internet Protocol OR Voice over IP OR VoIP OR IP telephony OR Internet telephony278	Nokia
TMVoice over Internet Protocol OR Voice over IP OR VoIP OR IP telephony OR Internet telephony1184	Microsoft
TMGreen IT OR Green information technology1093	Dell
TMGreen IT OR Green information technology1047	eBay
TMVideoconferencing OR videoconference OR video conference OR video conferencing555	eBay
TMGreen IT OR Green information technology548	Justice Department
TMGreen IT OR Green information technology423	eBay
TMVoice over Internet Protocol OR Voice over IP OR VoIP OR IP telephony OR Internet telephony25	eBay
TMGreen IT OR Green information technology482	Microsoft
TMVideoconferencing OR videoconference OR video conference OR video conferencing596	Intel
TMGreen IT OR Green information technology700	European Union
TMGreen IT OR Green information technology1079	CNN
TMGreen IT OR Green information technology915	Harvard
TMGreen IT OR Green information technology501	Microsoft
TMVoice over Internet Protocol OR Voice over IP OR VoIP OR IP telephony OR Internet telephony1295	eBay
TMVoice over Internet Protocol OR Voice over IP OR VoIP OR IP telephony OR Internet telephony15	Microsoft
TMVideoconferencing OR videoconference OR video conference OR video conferencing610	Comcast
TMGreen IT OR Green information technology1074	Microsoft
TMVideoconferencing OR videoconference OR video conference OR video conferencing618	Intel
TMGreen IT OR Green information technology543	Intel
TMVoice over Internet Protocol OR Voice over IP OR VoIP OR IP telephony OR Internet telephony1236	Cisco
TMVoice over Internet Protocol OR Voice over IP OR VoIP OR IP telephony OR Internet telephony1191	Vonage
TMVoice over Internet Protocol OR Voice over IP OR VoIP OR IP telephony OR Internet telephony2	Google
TMenvironmental sustainability OR environment sustainability OR environment sustainable620	Harvard
TMenvironmentally sustainable IT OR environmentally sustainable information technology OR environmentally friendly IT OR environmentally friendly information technology1322	Air Force
TMGreen IT OR Green information technology923	Microsoft
TMVoice over Internet Protocol OR Voice over IP OR VoIP OR IP telephony OR Internet telephony1236	Nokia
TMgreen grid1155	Department of Energy
TMVideoconferencing OR videoconference OR video conference OR video conferencing51	Cisco
TMVoice over Internet Protocol OR Voice over IP OR VoIP OR IP telephony OR Internet telephony1179	Nokia
TMenergy star OR energy stars583	Treasury
TMGreen IT OR Green information technology1021	Dell
TMGreen IT OR Green information technology1008	Treasury
TMGreen IT OR Green information technology1080	Intel
TMVoice over Internet Protocol OR Voice over IP OR VoIP OR IP telephony OR Internet telephony1301	Congress
TMVoice over Internet Protocol OR Voice over IP OR VoIP OR IP telephony OR Internet telephony872	eBay
TMGreen IT OR Green information technology785	Comcast
TMVideoconferencing OR videoconference OR video conference OR video conferencing601	Cisco
TMenvironmentally sustainable IT OR environmentally sustainable information technology OR environmentally friendly IT OR environmentally friendly information technology552	Microsoft
TMVoice over Internet Protocol OR Voice over IP OR VoIP OR IP telephony OR Internet telephony1265	Google
TMVoice over Internet Protocol OR Voice over IP OR VoIP OR IP telephony OR Internet telephony1314	Microsoft
TMVideoconferencing OR videoconference OR video conference OR video conferencing71	Dell
TMGreen IT OR Green information technology368	Intel
TMVideoconferencing OR videoconference OR video conference OR video conferencing1109	Microsoft
TMVideoconferencing OR videoconference OR video conference OR video conferencing571	Cisco
TMVoice over Internet Protocol OR Voice over IP OR VoIP OR IP telephony OR Internet telephony1164	Cisco
TMVoice over Internet Protocol OR Voice over IP OR VoIP OR IP telephony OR Internet telephony829	Congress
TMcomputer recycling OR electronic recycling OR computer recyc OR electronic recyc OR e recycling OR e recyc1159	Intel
TMGreen IT OR Green information technology461	New York Times
TMGreen IT OR Green information technology1092	New York Times
TMVoice over Internet Protocol OR Voice over IP OR VoIP OR IP telephony OR Internet telephony1253	Verizon
TMVoice over Internet Protocol OR Voice over IP OR VoIP OR IP telephony OR Internet telephony20	Vonage
TMGreen IT OR Green information technology1050	Senate
TMGreen IT OR Green information technology658	Microsoft
TMVoice over Internet Protocol OR Voice over IP OR VoIP OR IP telephony OR Internet telephony133	Nokia
TMGreen IT OR Green information technology368	Cisco
TMVoice over Internet Protocol OR Voice over IP OR VoIP OR IP telephony OR Internet telephony107	Verizon
TMVoice over Internet Protocol OR Voice over IP OR VoIP OR IP telephony OR Internet telephony1233	Senate
TMGreen IT OR Green information technology1072	Congress
TMGreen IT OR Green information technology654	Microsoft
TMGreen IT OR Green information technology444	Microsoft
TMGreen IT OR Green information technology1019	Microsoft
TMVoice over Internet Protocol OR Voice over IP OR VoIP OR IP telephony OR Internet telephony171	Associated Press
TMGreen IT OR Green information technology652	Cisco
TMVideoconferencing OR videoconference OR video conference OR video conferencing40	Hewlett Packard
TMGreen IT OR Green information technology684	Google
TMGreen IT OR Green information technology1064	Google
TMGreen IT OR Green information technology953	eBay
TMGreen IT OR Green information technology1052	Nokia
TMVideoconferencing OR videoconference OR video conference OR video conferencing62	Google
TMGreen IT OR Green information technology517	Microsoft
TMGreen IT OR Green information technology978	Dell
TMVoice over Internet Protocol OR Voice over IP OR VoIP OR IP telephony OR Internet telephony161	Intel
TMGreen IT OR Green information technology953	Dell
TMVoice over Internet Protocol OR Voice over IP OR VoIP OR IP telephony OR Internet telephony225	Cisco
TMenvironmentally sustainable IT OR environmentally sustainable information technology OR environmentally friendly IT OR environmentally friendly information technology1142	Hewlett Packard
TMVoice over Internet Protocol OR Voice over IP OR VoIP OR IP telephony OR Internet telephony1165	Cisco
TMGreen IT OR Green information technology629	Comcast
TMGreen IT OR Green information technology772	Senate
TMGreen IT OR Green information technology652	Microsoft
TMGreen IT OR Green information technology449	Microsoft
TMVoice over Internet Protocol OR Voice over IP OR VoIP OR IP telephony OR Internet telephony874	Google
TMenvironmentally sustainable IT OR environmentally sustainable information technology OR environmentally friendly IT OR environmentally friendly information technology1142	Dell
TMGreen IT OR Green information technology420	Congress
TMGreen IT OR Green information technology1069	City Council
TMVoice over Internet Protocol OR Voice over IP OR VoIP OR IP telephony OR Internet telephony1172	eBay
TMVoice over Internet Protocol OR Voice over IP OR VoIP OR IP telephony OR Internet telephony18	Justice Department
TMGreen IT OR Green information technology483	Cisco
TMVoice over Internet Protocol OR Voice over IP OR VoIP OR IP telephony OR Internet telephony1171	New York Times
TMVoice over Internet Protocol OR Voice over IP OR VoIP OR IP telephony OR Internet telephony1271	Verizon
TMGreen IT OR Green information technology1052	City Council
TMGreen IT OR Green information technology994	Nokia
TMVideoconferencing OR videoconference OR video conference OR video conferencing556	Intel
